12
************
*S         *
* *** ** * *
*   *    * *
* * * E *  *
*   C  * * *
***  *     *
* E  *  C  *
* **** * * *
*          *
*   *   *  *
*       * F*
