10
**********
*S  C    *
* ** *   *
*  *   * *
*  *E  * *
*   *C   *
* * *    *
*     E  *
*C   *  F*
**********
